9
10 20 30 40 50 60 70 80 90
3

-> 170

9
10 20 30 40 50 60 70 80 90
5

-> 110

15
568 712 412 231 241 393 865 287 128 457 238 98 980 23 782
4

->1785

15
1 1 1 1 1 1 1 1 1 1 1 1 1 1 1000
2

-> 1000

15
1 1 1 1 1 1 1 1 1 1 1 1 1 1 1000
4

-> 1000

7
50 50 50 50 50 50 50
2

-> 200

5    	
1 1 1 1 100
5

-> 100

10
950 650 250 250 350 100 650 150 150 700
6

->950